############
####   # ###
#  ### # # #
##         #
##### ####M#
#        ###
# ##### ## #
#     #  # #
## ## #### #
#   #      #
###I## # ###
############